France	Amandine Bourgeois	L'enfer et moi	Hell and me
Lithuania	Andrius Pojavis
Moldova	Aliona Moon	O mie	A thousand
Finland	Krista Siegfrids:Marry Me
Spain	ESDM	Contigo hasta el final	With you until the end
Belgium	Roberto Bellarosa	Love Kills
Estonia	Birgit	Et uus saaks alguse	So there can be a new beginning
Belarus	Alyona Lanskaya	Solayoh
Malta	Gianluca
Russia	Dina Garipova
Germany	Cascada
Armenia	Dorians	Lonely Planet
Netherlands	Anouk
Romania	Cezar	It's My Life
United Kingdom	Bonnie Tyler	Believe in Me
Sweden	Robin Stjernberg
Hungary	ByeAlex	Kedvesem	Zoohacker Remix	My darling
Denmark	Emmelie de Forest	Only Teardrops
Iceland	Eythor Ingi	Ég á líf	I am alive
Azerbaijan	Farid Mammadov	Hold Me
Greece	Koza Mostra	Agathon Iakovidis	Alcohol Is Free
Ukraine	Zlata Ognevich	Gravity
Italy	Marco Mengoni	L'essenziale	The essential
Norway	Margaret Berger	I Feed You My Love
Georgia	Nodi Tatishvili	Sophie Gelovani	Waterfall
Ireland	Ryan Dolan	Only Love Survives
